Canadá - Ottawa
Estados Unidos de América, - Washington
Estados Unidos Mexicanos - Ciudad de México
Belice - Belmopán
Costa rica - San José
El Salvador - San Salvador
Guatemala - Ciudad de Guatemala
Honduras - Tegucigalpa
Nicaragua - Managua
Panamá - Panamá
Argentina - Buenos Aires
Bolivia - Sucre
Brasil - Brasilia
Chile - Santiago de Chile
Colombia - Bogotá
Ecuador - Quito
Paraguay - Asunción
Perú - Lima
Surinam - Parabarimo
Trinidad y Tobago - Puerto España
Uruguay - Montevideo
Venezuela - Caracas
Antigua y Barbuda - Saint John
Bahamas - Nasáu
Barbados - Bridgetown
Cuba - La Habana
Dominica - Roseau
Granada - Saint George
Guyana - Georgetown
Haití - Puerto Príncipe
Jamaica - Kingston
República Dominicana - Santo Domingo
San Cristóbal y Nieves - Basseterre
San Vicente y las Granadinas - Kingstown
Santa Lucía - Castries